(0,155,155), 4, 0.5, 2
3
1,1
1,2
1,3
1
3,3
10,10
1, 0, 0, 1, 0, 1, 0, 1, 0, 1
1, 1, 0, 0, 0, 1, 0, 1, 1, 1
0, 0, 0, 0, 1, 0, 1, 0, 1, 0
0, 1, 0, 0, 1, 0, 1, 1, 1, 0
0, 1, 0, 0, 1, 0, 1, 1, 1, 0
0, 1, 0, 0, 1, 0, 1, 1, 1, 0
0, 1, 0, 0, 1, 0, 1, 1, 1, 0
0, 1, 0, 0, 1, 0, 1, 1, 1, 0
0, 1, 0, 0, 1, 0, 1, 1, 1, 0
0, 1, 0, 0, 1, 0, 1, 1, 1, 0
