4 
5, 0, 200, 50
4, 100, 30, 30
5, 20, 10, 10
5, 200, 10, 0
3
32
1, 2
1, 3
2, 2
2, 3
3, 2
3, 3
4, 2
4, 3
5, 2
5, 3
6, 2
6, 3
4, 1
4, 4
5, 1
5, 4
8, 7
8, 8
7, 6
7, 7
7, 8
7, 9
2, 7
3, 7
2, 8
3, 8
2, 9
3, 9
2, 10
3, 10
2, 11
3, 11
1
3, 3
10, 15
1, 1, 1, 1, 1, 1, 0, 0, 0, 0, 0, 0, 0, 1, 1
0, 0, 0, 0, 0, 1, 0, 0, 0, 0, 0, 0, 0, 1, 0
0, 0, 0, 0, 0, 1, 0, 0, 0, 0, 0, 0, 0, 1, 0
0, 0, 0, 0, 0, 1, 0, 0, 0, 0, 0, 0, 0, 1, 0
0, 0, 0, 0, 0, 1, 0, 0, 0, 0, 0, 0, 0, 1, 0
0, 0, 0, 0, 0, 1, 0, 0, 0, 0, 1, 1, 1, 1, 0
0, 0, 0, 0, 0, 1, 0, 0, 0, 0, 1, 0, 0, 0, 0
0, 0, 0, 0, 0, 1, 0, 0, 0, 0, 1, 0, 0, 0, 0
0, 0, 0, 0, 0, 1, 0, 0, 0, 0, 1, 0, 0, 0, 0
0, 0, 0, 0, 0, 1, 1, 1, 1, 1, 1, 0, 0, 0, 0
